[500] Days Of Summer - Music From The Motion Picture	(500) Days Of Summer Music From The Motion Picture
30 Seconds to Mars	This Is War
30 Seconds to Mars	A Beautiful Lie
A Camp	Colonia
A Fine Frenzy	Bomb In A Birdcage
A Perfect Circle	Thirteenth Step
Adam & the Ants	Kings Of The Wild Frontier
Adele	21
Against Me!	Russian Spies - Occult Enemies - Single
Alkaline Trio	This Addiction
Amy Winehouse	Frank (E-Version - Parental Advisory)
Amy Winehouse	Back To Black (Parental Advisory)
Army Navy	Army Navy
Asobi Seksu	Citrus
Au Revoir Simone	Still Night, Still Light
Augustana	All The Stars and Boulevards
Avi Buffalo	Avi Buffalo
Aziz Ansari	Intimate Moments For A Sensual Evening
Bad Meets Evil	Hell The Sequel (Parental Advisory)
Bananarama	The Very Best of Bananarama
Beach House	Teen Dream
Beastie Boys	Make Some Noise
Bee Gees	The Ultimate Bee Gees
Beirut	March of the Zapotec & Realpeople Holland
Belle & Sebastian	The Boy With The Arab Strap
Benjy Ferree	Come Back To The Five And Dime, Bobby Dee Bobby Dee
Best Coast	Crazy For You
Black Before Red	Belgrave To Kings Circle
Black Eyed Peas	The E n d  (the Energy Never Dies)
Blind Pilot	3 Rounds And A Sound
Block	Timing Is Everything
Bon Iver	Blood Bank
Bon Iver	Bon Iver
Brandon Boyd	The Wild Trapeze
Bright Eyes	The People's Key
Britney Spears	Circus (Deluxe Version)
Bruce Springsteen	The Essential Bruce Springsteen
Buddy Holly	The Definitive Collection
Built to Spill	There Is No Enemy
Buke And Gass	Riposte
Cass Elliot	Mama's Big Ones'
Cast - Phineas and Ferb	Phineas and Ferb Across the 1st and 2nd Dimensions
Chris Brown	Exclusive
Chris Brown	Graffiti
Chris Isaak	Mr  Lucky (Bonus Tracks)
Christina Aguilera	Bionic (Parental Advisory)
Christina Aguilera	Back To Basics
Coconut Records	Nighttiming
Corinne Bailey Rae	The Love E P
Corner Stone Cues Presents	Requiem For A Tower
Craig Ferguson	A Wee Bit O'Revolution
Cristina Ortiz	Beethoven Piano Sonatas - Pathétique, Tempest & Moonlight
Crystal Method	Divided By Night
Cut Chemist	The Audience's Listening
Cut Copy	Zonoscope
Daft Punk	Musique, Vol 1 (1993-2005)
Daft Punk	TRON Legacy Reconfigured
Dan Auerbach	Keep It Hid
Dario Marianelli	Atonement Music From The Motion Picture (International Version)
Dashboard Confessional	Alter The Ending (Deluxe)
Dave Edmunds	Repeat When Necessary
Dave Edmunds	Get It
Dave Edmunds	From Small Things The Best Of Dave Edmunds
Dave Matthews Band	Big Whiskey And The GrooGrux King
David Bowie	Hunky Dory
Death Cab for Cutie	Codes and Keys
Deerhunter	Halcyon Digest
Delta Spirit	Ode to Sunshine
Devo	The Essentials
Dharohar Project, Laura Marling, Mumford & Sons	Mumford & Sons, Laura Marling & Dharohar Project - Ep
Dinah Washington	The Essential Dinah Washington
DJ Khaled	Victory
Don Henley	The Very Best Of
Don Henley	Actual Miles Henley's Greatest Hits
Doug Stanhope	oslo burning the bridge to nowhere (Parental Advisory)
Dr  Dre	I Need A Doctor (Main)
Dropkick Murphys	Going Out In Style
E	A Man Called E
Easy Star All-Stars	Dub Side Of The Moon
Easy Star All-Stars	Radiodread
Eddie Vedder	Ukulele Songs
Eisley	The Valley (Deluxe Edition)
Ellie Goulding	Lights
Elvis Costello	The Delivery Man
Elvis Presley	Elvis 75
Eminem	3 A M  (Travis Barker Remix) (Parental Advisory)
Eminem	Relapse Refill (Parental Advisory)
Eminem	Relapse Refill (Edited)
Eminem	Encore (Parental Advisory)
Emmylou Harris	Pieces Of The Sky (Expanded)
Emmylou Harris	Heartaches & Highways The Very Best Of Emmylou Harris (Remastered)
Emmylou Harris	Blue Kentucky Girl
En Vogue	Best Of (Us)
Eric Clapton	August
Escape Club	Rhino Hi-Five The Escape Club
First Aid Kit	The Big Black And The Blue
Fleet Foxes	Fleet Foxes
Fleet Foxes	Helplessness Blues
Foo Fighters	Rope
Frank Turner	Poetry Of The Deed (Deluxe Edition)
Freelance Whales	Weathervanes
G  Love & Special Sauce	Fixin' To Die
Game	Doctor's Advocate (Parental Advisory)
Generationals	Con Law
Getaway Car	All Your Little Pieces
Glenn Gould	Goldberg Variations, BWV 988 (1981 Recording) (Expanded Edition)
Gordon Lightfoot	Summertime Dream
Gorillaz	The Fall
Grace Potter	Grace Potter & The Nocturnals
Green Day	21st Century Breakdown
Guns N' Roses	Appetite For Destruction (Parental Advisory)
Hall & Oates	The Essential Daryl Hall & John Oates
Hanson	Shout It Out
Hanson	The Walk
Hanson	This Time Around
Husky Rescue	Country Falls
Jake Shimabukuro	Peace Love Ukulele
Janelle Monáe	The Archandroid
Janis Joplin	The Essential Janis Joplin
Jason Derulo	Whatcha Say (Single)
Jason Mraz	We Sing, We Dance, We Steal Things (2 CD)
Jay-Z	The Blueprint 3 (Parental Advisory)
Jay-Z	Watch The Throne (Parental Advisory)
Jemina Pearl	Break It Up
Jens Lekman	Night Falls Over Kortedala
Jewel	Lullaby
Johann Sebastian Bach	J S  Bach Well-Tempered Clavier, Book 1
John Legend	Get Lifted
John Mellencamp	Life, Death, Love And Freedom (Deluxe Tour Edition)
John Pinette	I'm Starvin'
John Williams	Star Wars Episode II Attack Of The Clones (Original Motion Picture Soundtrack)
Joss Stone	LP1
Journey	Journey's Greatest Hits
Jurassic 5	J5 Deluxe Re-Issue
Justin Timberlake	FutureSex-LoveSounds (Parental Advisory)
Kanye West	Late Registration (Parental Advisory)
Kate Voegele	A Fine Mess (Deluxe)
Kate Voegele	Gravity Happens
Katy Perry	One Of The Boys
Kelly Clarkson	All I Ever Wanted (Deluxe Edition)
Kelly Clarkson	All I Ever Wanted
Kelly Clarkson	Breakaway
Komeda	Kokomemedada
Komeda	Check It Out
Komeda	Cul-De-Sac
Kool & the Gang	20th Century Masters - The Millennium Collection The Best Of Kool & The Gang
Lady GaGa	The Fame Monster (Deluxe)
Lady GaGa	Born This Way (Special Edition)
LCD Soundsystem	This Is Happening
Les Rythmes Digitales	Darkdancer
Lewis Black	Stark Raving Black
Liam Finn	Champagne In Seashells
Liam Finn	I'll Be Lightning
Lil Wayne	I Am Not A Human Being
Linda Ronstadt	Linda Ronstadt Box Set
Linkin Park	New Divide (Single)
Lissie	Catching A Tiger
Liverpool Express	The Best Of Liverpool Express
Living Colour	Vivid
Liz Phair	Exile In Guyville (Bonus Tracks)
Los Straitjackets	!Viva! Los Straitjackets
Louis C K	Hilarious
Louis C K	Chewed Up (Parental Advisory)
Luna	The Best Of Luna (Remastered)
Lykke Li	Youth Novels
M  Ward	Hold Time
Madonna	Celebration (Double Disc Version)
Magnetic Fields	69 Love Songs
Magnetic Man	Magnetic Man
Margaret Cho	Beautiful
Marina & the Diamonds	The Family Jewels
Maroon 5	Hands All Over
Massive Attack	Mezzanine
Massive Attack	Collected
Max Richter	The Blue Notebooks
Meaghan Smith	The Cricket's Orchestra
Menomena	I'm Am The Fun Blame Monster!
Metric	Fantasies
Michael Bublé	Call Me Irresponsible
Michael Kamen	Don Juan Demarco Original Soundtrack
Miike Snow	Miike Snow
Mikey Dread	World War 3
Miley Cyrus	Hannah Montana The Movie
Miley Cyrus	Hannah Montana 3
Miniature Tigers	Tell It To The Volcano
Minus the Bear	Omni
Mirah	Advisory Committee
Mo' Horizons	And The New Bohemian Freedom
Moby	Go The Very Best Of Moby
Monsters of Folk	Monsters Of Folk
My Morning Jacket	Circuital
Needtobreathe	The Outsiders
Needtobreathe	The Heat
Neil Diamond	Neil Diamond Classics The Early Years
Neko Case	Middle Cyclone
Neko Case & Her Boyfriends	Fox Confessor Brings The Flood
Nelly Furtado	Loose
Neon Indian	Mind Ctrl Psychic Chasms Possessed
Nick Lowe	Basher The Best Of Nick Lowe
Nico Vega	Nico Vega
Nik Kershaw	Wouldn't It Be Good
Nouvelle Vague	3
Nouvelle Vague	I Melt With You - Teenage Kicks
Ohio Express	The Best Of The Ohio Express
Okkervil River	I Am Very Far
Original Broadway Cast	The Book of Mormon
Original Cast	Spider-Man Turn Off The Dark
Original Cast Recording	Khaaaaan! the Musical
Owl City	Ocean Eyes
Owl City	All Things Bright And Beautiful
Ozzy Osbourne	Diary Of A Madman (Legacy Edition)
Paramore	Riot! (With Bonus Track)
Paramore	Brand New Eyes
Passion Pit	Manners
Peaches	The Teaches Of Peaches (Bonus Tracks) (Parental Advisory)
Pearl Jam	Pearl Jam
Philip Glass	Animals In Love
PJ Harvey	Let England Shake
Plain White T's	Big Bad World
PlantLife	Time Traveller
Porcupine Tree	The Incident
Portugal  The Man	In The Mountain In The Cloud
Preservation Hall Jazz Band	Made In New Orleans The Hurricane Sessions
Prince	Purple Rain
Priscilla Ahn	A Good Day
Pulp	This Is Hardcore
Quasimoto	The Further Adventures Of Lord Quas
Randy Newman	The Princess And The Frog
Randy Newman	Ragtime Original Soundtrack (Remastered & Expanded)
Ray Charles	The Best Of Ray Charles The Atlantic Years
Ray LaMontagne	Trouble
Ray LaMontagne	Gossip In The Grain
Ray Lamontagne And The Pariah Dogs	God Willin'& The Creek Don't Rise
Red River	Little Songs About The Big Picture
Regina Spektor	Far (Deluxe DMD)
Richard Swift	The Atlantic Ocean
Rihanna	Good Girl Gone Bad Reloaded
Rihanna	Rated R (Parental Advisory)
Rob Thomas	Her Diamonds (Single)
Robbie Robertson	How To Become Clairvoyant
Salt-N-Pepa	The Best Of Salt-N-Pepa 20th Century Masters - The Millennium Collection
Sara Bareilles	Kaleidoscope Heart
Sarah Jarosz	Song Up In Her Head
Sarah Jarosz	Follow Me Down
Sarah McLachlan	Fumbling Towards Ecstasy
Scala & Kolacny Brothers	Scala & Kolacny Brothers
Scott H  Biram	Something's Wrong-lost Forever
Section Quartet	Fuzzbox
Selena Gomez	When The Sun Goes Down
Selena Gomez	When The Sun Goes Down (1)
Sheryl Crow	The Very Best Of (Digital)
Silversun Pickups	Swoon
Silversun Pickups	Carnavas
Slayer	World Painted Blood
Spike Jones	Spike Jones & His City Slickers Mistaken Music
Squeeze	East Side Story
Squeeze	Argy Bargy (Deluxe Edition)
Squeeze	Sweets From A Stranger
Stephen Sondheim	Company
Stereolab	Emperor Tomato Ketchup
Sting	If On A Winter's Night
Sufjan Stevens	Seven Swans
Surfer Blood	Astro Coast
T I	Paper Trail (Parental Advisory)
Taylor Swift	Fearless
Telling Stories	Greyhound
The Airborne Toxic Event	The Airborne Toxic Event (Deluxe Edition)
The Airborne Toxic Event	All At Once
The All-American Rejects	When The World Comes Down
The Aquabats	Hi-Five Soup!
The Avett Brothers	I And Love And You
The Band	The Band (Remasters)
The Besnard Lakes	The Besnard Lakes Are The Dark Horse
The Besnard Lakes	The Besnard Lakes Are The Roaring Night
The Bird and the Bee	Interpreting The Masters Volume 1 A Tribute To Daryl Hall And John Oates
The Bird and the Bee	The Bird And The Bee (Parental Advisory)
The Black Keys	Brothers
The Cars	Move Like This
The Chemical Brothers	Surrender
The Civil Wars	Barton Hollow
The Clash	London Calling (Legacy Edition)
The Clash	The Essential Clash
The Cranberries	No Need To Argue
The Cribs	Ignore The Ignorant
The Crystal Method	Vegas (Deluxe Edition)
The Cure	Disintegration (Deluxe Edition)
The Dead Weather	Horehound
The Decemberists	Hazards Of Love
The Donkeys	Born With Stripes
The Drums	The Drums
The Ettes	Do You Want Power
The Fray	The Fray
The Gutter Twins	Saturnalia
The Head and the Heart	The Head And The Heart
The Joy Formidable	Roarities
The Joy Formidable	The Big Roar
The Lonely Island	Turtleneck & Chain (Parental Advisory)
The Long Winters	Putting The Days To Bed
The Marcels	Blue Moon-Goodbye To Love (Digital 45)
The Monkees	The Best Of The Monkees
The Morning Benders	Big Echo
The Naked and Famous	Passive Me, Aggressive You
The Pains of Being Pure at Heart	Young Adult Friction
The Pierces	Thirteen Tales Of Love And Revenge
The Raveonettes	Raven In The Grave
The Raveonettes	Lust Lust Lust (Bonus Track Version)
The Rolling Stones	Exile On Main Street (Deluxe Version)
The Script	Science & Faith
The Strokes	Angles
The Tallest Man on Earth	The Wild Hunt
The Ting Tings	We Started Nothing
The Tragically Hip	Yer Favourites (Remastered)
The Twilight Singers	Dynamite Steps
The Veronicas	Hook Me Up
The Verve	Urban Hymns
The Walkmen	Lisbon
Them Crooked Vultures	Them Crooked Vultures
They Might Be Giants	Here Comes Science
Thievery Corporation	Culture of Fear
Tinted Windows	Tinted Windows
TLC	Now & Forever The Hits
Train	Save Me, San Francisco
Treme Brass Band	The Treme Brass Band
Trombone Shorty	Backatown
tUnE-yArDs	W H O K I L L
Two Door Cinema Club	Tourist History
Underworld	Barking
Various Artists	Rhino Hi-Five - Singers-Songwriters The '90s
Various Artists	Essential Mozart Opera
Various Artists	Bandslam
Various Artists	Reggae Anthology Cutty Ranks - Limb By Limb
Wale	Attention Deficit (Parental Advisory)
Wax on Radio	Exposition
Weezer	Weezer (Green Album)
Weezer	Raditude (Deluxe)
Weird Al Yankovic	Alpocalypse
When Saints Go Machine	Konkylie
Wicked	Wicked - The Musical
Wilco	Wilco (The Album)
Wye Oak	Civilian
Young the Giant	Young The Giant
Zakir Hussain	Zakir Hussain Digital Collection 2
Zakir Hussain	Zakir Hussain Best Of Zakir Hussain, feat  Fazal Qureshi
